t y 0 t t t t t 0 0 0 0 0 0 t 
t t 0 t 0 0 0 t 0 t t t t b t 
t v 0 t 0 t 0 t 0 0 0 0 t t t 
t 0 0 t 0 0 h 0 0 0 0 0 0 v t 
t 0 0 t 0 m m 0 m m 0 0 0 0 b 
t 0 0 0 0 0 m 0 m m m 0 0 0 0 
t 0 m 0 0 0 m 0 m b 0 0 0 0 0 
t 0 m 0 0 0 m 0 m m m m 0 0 0 
0 0 m 0 0 0 m 0 0 0 0 0 0 0 0 
0 0 m b 0 0 m 0 0 0 m m m m m 
0 m m m m 0 m 0 0 m m m m b m 
0 b m 0 0 0 m 0 m m 0 m m 0 m 
0 0 m 0 0 0 m 0 0 0 0 0 0 0 m 
0 0 m 0 0 0 0 0 0 0 0 0 0 h m 
0 0 0 0 0 v m m m m m m m m m