m 0 0 0 m m 0 v 0 0 0 0 0 0 t 
0 0 m 0 b m 0 0 0 t t t t 0 t 
0 m m m m m 0 0 0 0 0 t t b t 
0 0 0 0 0 0 0 0 0 0 0 0 t t t 
h 0 0 0 0 0 0 0 0 0 0 0 0 t t 
0 0 0 0 0 t t 0 t t t 0 0 t t 
0 0 0 0 0 b t 0 t b t 0 0 t t 
0 m 0 0 0 t t 0 t 0 t 0 0 0 t 
0 m m 0 0 0 0 0 t 0 t 0 0 0 0 
0 0 m 0 0 0 0 0 0 0 0 0 0 0 h 
0 0 m 0 0 0 0 0 0 0 0 m 0 0 0 
m 0 m 0 0 t t t t t 0 m m 0 0 
m 0 m 0 0 t 0 0 0 t 0 m m 0 0 
m b m 0 0 t 0 t 0 t 0 m m m y 
m m m v 0 0 b t 0 0 0 m m m m