m m m v 0 0 0 b t t 0 v m m m 
m b m 0 0 0 0 t t 0 0 0 m b m 
m 0 m 0 0 0 t t 0 0 0 0 m 0 m 
m 0 m 0 0 t t 0 0 0 0 0 0 0 m 
m 0 0 0 t t 0 0 0 0 0 0 m m m 
m h 0 0 0 0 0 0 0 0 0 0 0 0 0 
m m m 0 0 0 0 0 0 0 0 0 m m m 
0 b t 0 t t t t t t t 0 0 0 m 
0 t t 0 0 0 0 0 0 b t 0 0 0 0 
0 0 t 0 0 0 t t t t t 0 t 0 0 
t 0 t 0 0 0 t 0 0 0 t 0 t 0 0 
0 0 t 0 0 0 t 0 t 0 t 0 t 0 0 
0 t t 0 0 0 t 0 t 0 0 0 t t 0 
0 0 0 0 0 0 0 0 t t t t t t y 
h 0 0 0 0 0 0 0 0 0 0 0 b t t