m m m m m 0 b v 0 0 m m m m m 
0 m m m 0 0 0 0 0 0 0 m m m b 
0 0 m 0 0 0 0 0 0 0 0 0 m 0 0 
0 0 0 0 0 0 0 0 0 0 0 0 0 0 h 
0 0 0 0 0 0 0 0 0 0 0 0 0 0 0 
0 0 0 t 0 0 0 0 0 0 0 t 0 0 0 
0 0 t t t 0 0 0 0 0 t t t 0 0 
y t t t t t 0 b 0 t t t t t 0 
0 0 t t t 0 0 0 0 0 t t t b 0 
0 0 0 t 0 0 0 0 0 0 0 t 0 0 0 
0 0 0 0 0 0 0 0 0 0 0 0 0 0 0 
h 0 0 0 0 0 0 0 0 0 0 0 0 0 0 
0 0 m 0 0 0 0 0 0 0 0 0 m 0 0 
0 m m m 0 0 0 0 0 0 0 m m m 0 
m m m m m b 0 v 0 0 m m m m m