m m 0 0 0 0 m y 0 0 t 0 0 v 0 
m v 0 m m b m 0 0 0 t 0 t 0 0 
m 0 m m m m m 0 0 t t 0 t 0 b 
m 0 0 0 0 0 m 0 t t t 0 t 0 0 
m 0 m m m 0 m 0 0 t t 0 t 0 0 
m 0 m m m 0 m 0 0 0 t 0 t 0 t 
m 0 0 0 0 0 0 0 0 0 0 0 0 0 t 
t 0 0 0 0 0 0 0 0 0 0 0 0 h t 
t 0 0 0 0 0 0 0 0 0 0 0 0 0 t 
t 0 t t t 0 t t b 0 0 0 0 0 t 
t 0 0 t 0 0 0 t t 0 0 0 0 m m 
t 0 0 0 0 0 0 0 t t 0 0 m m m 
t 0 0 t 0 0 0 0 0 t 0 m m b m 
t 0 0 b 0 v 0 t 0 0 0 0 m 0 m 
t t t t t t t t t t t 0 0 0 m